General Information - 1998 Election: Western Australia			
Polling Places			

Brand			
Polling Place Name	Premises	Address	Suburb
Baldivis	Baldivis Hall	Fifty Road	BALDIVIS
Broome (Brand)	Broome Shire Hall	Weld St	BROOME
Calista	Calista Primary School	Chilcott Street	CALISTA
Carnarvon (Brand)	Carnarvon Senior High School	Cleaver Street	CARNARVON
Coodanup	Coodanup Senior High School	Wanjeep Street	COODANUP
Cooloongup	Cooloongup Primary School	Westerly Way	COOLOONGUP
Exmouth (Brand)	Exmouth Shire Hall	Maidestone Cres	EXMOUTH
Golden Bay	Coastal Community Centre	Tangadee Road	GOLDEN BAY
Greenfields	Bortolo Pavilion	Murdoch Dr	GREENFIELDS
Greenfields East	Riverside Primary School	Teranca Rd	GREENFIELDS
Halls Head	Glencoe Primary School	Balmoral Parade	HALLS HEAD
Halls Head South	Halls Head Primary School	Oleander Pl	HALLS HEAD
Hillman	Hillman Primary School	Unnaro Street	HILLMAN
Hope Valley	Hope Valley Primary School	McLaren Ave	HOPE VALLEY
Kalbarri (Brand)	Kalbarri - Allen Community Centre	Grey Street	KALBARRI
Leda	Leda Primary School	Feilman Dr	LEDA
Madora	Ron Christian Memorial Hall	Orelia Street	MADORA
Mandurah	Baden Powell Hall	Cnr Anstruther Rd & Elizabeth St	MANDURAH
Mandurah Central	Mandurah Primary School	Hackett Street	MANDURAH
Mandurah East	Mandurah Police & Citizens Youth Hall	Dower Street	MANDURAH
Mandurah South	Dudley Park Primary School	Gillark Street	DUDLEY PARK
Meadow Springs	Frederick Irwin Anglican Community School	Gordon Rd	MEADOW SPRINGS
Medina	Medina Primary School	Medina Ave	MEDINA
Parmelia	North Parmelia Primary School	Durrant Ave	PARMELIA
Perth (Brand)	Perth Town Hall	Hay St	PERTH
Port Kennedy	Port Kennedy Primary School	La Manche Ave	PORT KENNEDY
Rockingham	Rockingham Senior High School	Read Street	ROCKINGHAM
Rockingham Beach	Rockingham Beach Primary School	Bay View Street	ROCKINGHAM
Rottnest (Brand)	Rottnest Primary School		ROTTNEST ISLAND
Safety Bay	Safety Bay Primary School	Rae Rd	SAFETY BAY
Safety Bay Central	Safety Bay Senior High School	Malibu Rd	SAFETY BAY
Secret Harbour	Secret Harbour Community Centre	Maratea Pde	SECRET HARBOUR
Singleton	Singleton Hall	Cavender Street	SINGLETON
Waikiki	Charthouse Primary School	43 Rand Ave	WAIKIKI
Warnbro	Warnbro Primary School	Axminster St	WARNBRO
Warnbro East	Koorana Primary School	Coronata Drive	WARNBRO
Wellard	Casuarina-Wellard Community Centre	Corner Mortimer & Barker Roads	WELLARD
			
			
Canning			
Polling Place Name	Premises	Address	Suburb
Armadale	Neerigen Brook Primary School	Seventh Rd	ARMADALE
Armadale East	Armadale Primary School	Carradine Rd	ARMADALE
Armadale North	Kingsley Primary School	Lathwell St	ARMADALE
Armadale South	Armadale Kelmscott Senior Citizens Centre	Coombe Ave	ARMADALE
Armadale West	Challis Primary School	40 Braemore St	ARMADALE
Barragup	West Murray Community Centre	Pinjarra Road	BARRAGUP
Bedfordale	Bedfordale District Hall	Admiral Rd	BEDFORDALE
Broome (Canning)	Broome Shire Hall	Weld St	BROOME
Byford	Byford Primary School	Clifton St	BYFORD
Carcoola	Carcoola Primary School	Wisteria Cres	CARCOOLA
Carnarvon (Canning)	Carnarvon Senior High School	Cleaver Street	CARNARVON
Coolup	Coolup CWA Rest Room	Murray Street	COOLUP
Dawesville	Southern Estuary Progress Assn Hall	Estuary Road	DAWESVILLE
Dwellingup	Dwellingup Primary School	Newton Sreet	DWELLINGUP
Exmouth (Canning)	Exmouth Shire Hall	Maidestone Cres	EXMOUTH
Falcon	Falcon Football Pavilion	Cnr Lynda & Flame Sts	FALCON
Forrestdale	Forrestdale District Hall	Weld St	FORRESTDALE
Gosnells	Gosnells Primary School	Cnr May & Hicks Sts	GOSNELLS
Gosnells Central	Gosnells Civic Centre (Lesser Hall)	2242 Albany Hwy	GOSNELLS
Gosnells South	Gosnells Senior High School	Southern River Rd	GOSNELLS
Gosnells West	Wirrabirra Primary School	Cnr Corfield & Jenkinson Sts	GOSNELLS
Huntingdale	Huntingdale Primary School	Matilda St	HUNTINGDALE
Jarrahdale	Jarrahdale Primary School	Wanliss St	JARRAHDALE
Kalbarri (Canning)	Kalbarri - Allen Community Centre	Grey Street	KALBARRI
Kelmscott	Kelmscott Senior High School	Third Ave	KELMSCOTT
Kelmscott East	Kelmscott Primary School	River Rd	KELMSCOTT
Kelmscott North	Clifton Hills Primary School	Connell Ave	KELMSCOTT
Kenwick	East Kenwick Primary School	Kenwick Rd	KENWICK
Maddington	East Maddington Primary School	Pitchford Ave	MADDINGTON
Maddington East	Maddington Snr High School	Dellar Rd	MADDINGTON
Maddington North	Bramfield Park Primary School	Yule St	MADDINGTON
Mundijong	Mundijong Primary School	Livesey St	MUNDIJONG
North Dandalup	North Dandalup Lesser Hall	South West Highwy	NORTH DANDALUP
Oakford	Oakford Primary School	Kargotich Rd	OAKFORD
Perth (Canning)	Perth Town Hall	Hay St	PERTH
Pinjarra	Pinjarra Senior Citizens Centre	Pinjarra Rd	PINJARRA
Rottnest (Canning)	Rottnest Primary School		ROTTNEST ISLAND
Serpentine	Serpentine Ambulance Hall	Wellard St	SERPENTINE
Strawberry Fields	Cecil Andrews Snr High School	Seville Dve	ARMADALE
Thornlie (Canning)	Thornlie Senior High School	Ovens Rd	THORNLIE
Thornlie East	Thornlie Primary School	Thornlie Ave	THORNLIE
Thornlie South (Canning)	Forest Crescent Primary School	Forest Cres	THORNLIE
Thornlie West (Canning)	Yale Primary School	Cnr Yale & Sage Rds	THORNLIE
Westfield	Westfield Park Primary School	Hemingway Dve	WESTFIELD
Westfield South	Grovelands Primary School	Grovelands Dve	WESTFIELD
Wungong	Gwynne Park Primary School	Tijuana Rd	WUNGONG
Yunderup	Sth Yunderup/Ravenswood Fire Brigade Station	Yunderup Rd	SOUTH YUNDERUP
Yunderup North	North Yunderup CWA Centre	45 Culeenup Rd	NORTH YUNDERUP
Alexander Heights	Alinjarra Primary School	Avila Way	ALEXANDER HEIGHTS
			
			
Cowan			
Polling Place Name	Premises	Address	Suburb
Alexander Heights West	Alexander Heights Community Hall	Linto Way	ALEXANDER HEIGHTS
Ballajura	Illawarra Primary School	Illawarra Cres N	BALLAJURA
Ballajura Central	Ballajura Primary School	Illawarra Cres South	BALLAJURA
Ballajura South	South Ballajura Primary School	Wyperfeld Gdns	BALLAJURA
Beechboro West (Cowan)	John Septimus Roe Anglican Community School	Blackboy Way	BEECHBORO
Broome (Cowan)	Broome Shire Hall	Weld St	BROOME
Camboon	Camboon Primary School	Forder Street	NORANDA
Carnarvon (Cowan)	Carnarvon Senior High School	Cleaver Street	CARNARVON
Exmouth (Cowan)	Exmouth Shire Hall	Maidestone Cres	EXMOUTH
Girrawheen	Blackmore Primary School	Allinson Dve	GIRRAWHEEN
Girrawheen Central	Montrose Primary School	Stebbing Way	GIRRAWHEEN
Girrawheen East	Hainsworth Primary School	Harford Way	GIRRAWHEEN
Greenwood	Greenwood Senior High School	Coolibah Dve	GREENWOOD
Greenwood East	East Greenwood Primary School	Mulligan Dve	GREENWOOD
Greenwood West	Allenswood Primary School	Merivale Way	GREENWOOD
Hampton Park (Cowan)	Hampton Park Primary School	Hamersley Place	MORLEY
Kalbarri (Cowan)	Kalbarri - Allen Community Centre	Grey Street	KALBARRI
Kingsley	Creaney Primary School	Creaney Dve	KINGSLEY
Kingsley East	Halidon Primary School	Halidon Street	KINGSLEY
Kingsley South	Goollelal Primary School	Cadogan Street	KINGSLEY
Koondoola	Koondoola Primary School	Burbridge Ave	KOONDOOLA
Landsdale	Landsdale Gardens Kindergarten & Pre-Primary School	Warradale Terrace	LANDSDALE
Marangaroo	Marangaroo Primary School	Giralt Rd	MARANGAROO
Marangaroo Central	Marangaroo Family Centre	46 Highclere Blvd	MARANGAROO
Morley North	Uniting Church Hall	Lincoln Rd	MORLEY
Noranda	Noranda Primary School	Walmsley Dve	NORANDA
Noranda West (Cowan)	North Morley Primary School	Gordon Rd West	DIANELLA
Perth (Cowan)	Perth Town Hall	Hay St	PERTH
Rottnest (Cowan)	Rottnest Primary School		ROTTNEST ISLAND
Wanneroo (Cowan)	Wanneroo Primary School	Wanneroo Rd	WANNEROO
Wanneroo East (Cowan)	Wanneroo Senior High School	Quarkum St	WANNEROO
Warwick	Greenwood-Warwick Community Care Centre	Dorchester Ave	WARWICK
Warwick West	Hawker Park Primary School	Hawker Avenue	WARWICK
Woodvale	Woodvale High School	Woodvale Dve	WOODVALE
Woodvale North	North Woodvale Primary School	Chichester Dve	WOODVALE
Broome (Curtin)	Broome Shire Hall	Weld St	BROOME
			
			
Curtin			
Polling Place Name	Premises	Address	Suburb
Carnarvon (Curtin)	Carnarvon Senior High School	Cleaver Street	CARNARVON
City Beach	City Beach Primary School	Marapana Rd	CITY BEACH
City Beach North	Holy Spirit School	Brompton Rd	CITY BEACH
Claremont	Claremont Primary School	Bay View Tce	CLAREMONT
Claremont East	St Andrews Church	cnr Napier St & Stirling Hwy	NEDLANDS
Cottesloe	Cottesloe Civic centre	109 Broome Street	COTTESLOE
Cottesloe East	North Cottesloe Primary School	100 Eric Street	COTTESLOE
Cottesloe South	Cottesloe School for Deaf and Hearing Impaired Children	Johnston Street	PEPPERMINT GROVE
Dalkeith	Dalkeith Primary School	Circe Circle	DALKEITH
Doubleview (Curtin)	Doubleview Primary School	St Brigid's Tce	DOUBLEVIEW
Exmouth (Curtin)	Exmouth Shire Hall	Maidestone Cres	EXMOUTH
Floreat	Floreat Primary School	Chandler Ave	FLOREAT
Floreat East	Floreat Park Pre-Primary School	cnr Birkdale & Newry Street	FLOREAT
Floreat North	Churchlands Pre-Primary Centre	Brookdale Street	FLOREAT
Graylands	Graylands Primary School	cnr Alfred Rd & Montgomery Ave	MT CLAREMONT
Jolimont	Jolimont Primary School	657 Hay Street	JOLIMONT
Joondanna	"St Denis Primary School,"	157 Powell Street	JOONDANNA
Kalbarri (Curtin)	Kalbarri - Allen Community Centre	Grey Street	KALBARRI
King Edward Memorial Hospital	King Edward Memorial Hospital	Bagot Rd	SUBIACO
Leederville	Leederville College of TAFE	Cnr Oxford & Richmond Streets	LEEDERVILLE
Leederville North	Aranmore College Hall	cnr Oxford & Franklin Street	LEEDERVILLE
Leederville West	West Leederville Primary School	Northwood Street	LEEDERVILLE
Mosman Park	Mosman Park Memorial Hall	16 Lochee Street	MOSMAN PARK
Mosman Park South	All Saints Anglican Church	Jameson Street	MOSMAN PARK
Mount Hawthorn	Mt Hawthorn Primary School	Matlock Street	MOUNT HAWTHORN
Mount Hawthorn East	Mt Hawthorn Baptist Church	cnr Edinboro & Hobart Street	MOUNT HAWTHORN
Mount Hawthorn West	Mt Hawthorn Scout Hall	cnr East & Berryman Street	MOUNT HAWTHORN
Nedlands Central	UWA Nedlands Campus	Clifton St	NEDLANDS
Nedlands East	Drabble House	2 Webster Street	NEDLANDS
Nedlands North	Hollywood Primary School	Monash Ave	NEDLANDS
Nedlands South	Nedlands Primary School	35 Kingsway	NEDLANDS
Peppermint Grove	Star of the Sea Parish Hall	Cnr McNeil & Stirling Hwy	PEPPERMINT GROVE
Perth (Curtin)	Perth Town Hall	Hay St	PERTH
Rottnest (Curtin)	Rottnest Primary School		ROTTNEST ISLAND
Scarborough Central (Curtin)	Scarborough Pre-Primary School	Bazaar Tce	SCARBOROUGH
Shenton Park East	St Aloysius Catholic Church	Keightley Rd	SHENTON PARK
Shenton Park West	Rosalie Pre-Primary School (Off-site)	334 Onslow Rd	SHENTON PARK
Sir Charles Gairdner Hospital	Sir Charles Gairdner Hospital	E Block Diagnostic Centre	NEDLANDS
Subiaco	Subiaco Primary School	Bagot Rd	SUBIACO
Subiaco Brightwater	Subiaco Brightwater	Thomas Street	SUBIACO
Subiaco North	Perth Modern School	Roberts Rd	SUBIACO
Swanbourne	Swanbourne Primary School	Derby Street	SWANBOURNE
Wembley Central	Wembley Church of Christ	Nanson Street	WEMBLEY
Wembley Downs	Wembley Downs Primary School	Bournemouth Cres	WEMBLEY DOWNS
Wembley North	Lake Monger Primary School	Dodd Street	WEMBLEY
Wembley South	St Joseph's Parish Centre	1 Salvado Rd	WEMBLEY
Wembley West	Wembley Primary School	cnr Grantham & Alexander Street	WEMBLEY
West Perth (Curtin)	Greek Orthodox Church	Cnr Charles & Carr Streets	WEST PERTH
West Perth Central	Ross Memorial Hall	Cnr Hay & Colin Street	WEST PERTH
Woodlands	Woodlands Primary School	Bentwood Ave	WOODLANDS
Woodlands North	Teakwood Community Kindergarten	16 Tamarisk Way	WOODLANDS
			
			
Forrest			
Polling Place Name	Premises	Address	Suburb
Acton Park	Acton Park Hall		ACTON PARK
Albany	Albany Primary School	Albany Hwy	ALBANY
Albany Central	Albany CWA Hall	Serpentine Rd	ALBANY
Albany Regional Hospital	Albany Hosp Staff Rec Room	Hardie Rd	ALBANY
Alexandra Bridge	Alexandra Bridge Hall		ALEXANDRA BRIDGE
Augusta	Augusta Civic Centre	Allnutt Tce	AUGUSTA
Balingup	Balingup Primary School	Brockman Street	BALINGUP
Bayonet Head	Flinders Park Primary School	Yatana Rd	ALBANY
Bornholm	Bornholm Hall		BORNHOLM
Boyanup	Boyanup Primary School		BOYANUP
Boyup Brook	Boyup Brook Family Centre	Abel St	BOYUP BROOK
Bridgetown	Bridgetown Town Hall	Steere Street	BRIDGETOWN
Brookhampton	Brookhampton Hall		BROOKHAMPTON
Broome (Forrest)	Broome Shire Hall	Weld St	BROOME
Bunbury	Bunbury Pre-primary Centre	Lovegrove Ave	BUNBURY
Bunbury Central	Electoral sub-office (opp Bunbury Tower)	24 Victoria St	BUNBURY
Bunbury East	Cooinda Primary School	Trott Street	BUNBURY
Bunbury Regional Hospital	Bunbury Hosp Admin Area	Blair Street	BUNBURY
Bunbury St Johns Hospital	St Johns Hosp Reception Area	Parkfield Street	BUNBURY
Burekup	Burekup CWA Hall		BUREKUP
Busselton	Churchill Park Pavilion	Adelaide St	BUSSELTON
Busselton East	Busselton Primary School	Avocet Blvd	BUSSELTON
Busselton West	West Busselton Primary School	Bower Rd	BUSSELTON
Capel	Capel Hall		CAPEL
Carbunup River	Carbunup River Hall	Wildwood Rd	CARBUNUP RIVER
Carey Park	Carey Park Primary School	Frankel Street	BUNBURY
Carey Park South	Milligan House	Milligan Street	BUNBURY
Carnarvon (Forrest)	Carnarvon Senior High School	Cleaver Street	CARNARVON
Centennial Park	Centennial Park Scout Hall	Sanford Rd	ALBANY
Chowerup	Chowerup Primary School		CHOWERUP
Coral Park	Newton Moore Senior High School	Hotchin Street	BUNBURY
Cowaramup	Cowaramup Primary School	Waverley Rd	COWARAMUP
Dardanup	Dardanup Hall		DARDANUP
Deanmill	Deanmill Primary School		DEANMILL
Denmark	Denmark Recreation Centre	Brazier St	DENMARK
Dinninup	Dinninup Hall		DINNINUP
Donnybrook	Donnybrook Memorial Hall		DONNYBROOK
Dunsborough	Dunsborough Progress Assoc Hall	Gifford Rd	DUNSBOROUGH
Eaton	Eaton Hall	Pratt Rd	EATON
Elgin	Elgin Hall		ELGIN
Elleker	Elleker Hall		ELLEKER
Emu Point	Emu Point Sea Rescue Hall		ALBANY
Exmouth (Forrest)	Exmouth Shire Hall	Maidestone Cres	EXMOUTH
Ferguson	Ferguson Hall		FERGUSON
Gelorup	Gelorup Community Centre	Hasties Rd	GELORUP
Greenbushes	Greenbushes Primary School		GREENBUSHES
Kalbarri (Forrest)	Kalbarri - Allen Community Centre	Grey Street	KALBARRI
Karridale	Karridale Primary School	Bussell Hwy	KARRIDALE
King River	King River Hall	Millbrook Rd	KING RIVER
Kirup	Kirup Primary School		KIRUP
Kudardup	Kudardup Hall		KUDARDUP
Little Grove	South Coast Progress Assn Hall		LITTLE GROVE
Lockyer	Mt Lockyer Primary School	South Coast Hwy	ALBANY
Lowden	Yabberup Hall		LOWDEN
Lower Kalgan	Lower Kalgan Hall		LOWER KALGAN
Lower King	Lower King Pre-primary Centre	Rutherford Dr	LOWER KING
Ludlow	CALM School Building		LUDLOW
Manjimup	Manjimup Town Hall	Rose Street	MANJIMUP
Manjimup East	East Manjimup Primary School	O'Connor Street	MANJIMUP
Manypeaks	Mt Manypeaks Primary School		MANYPEAKS
Margaret River	Margaret River Senior High School	Bussell Hwy	MARGARET RIVER
Mayanup	Mayanup Hall		MAYANUP
Middlesex	Middlesex Hall		MIDDLESEX
Middleton Beach	Middleton Beach Surf Club		ALBANY
Nannup	Nannup Shire Office Function Room	Adam Rd	NANNUP
Napier	Napier Hall		NAPIER
Northcliffe	Northcliffe Ambulance Hall		NORTHCLIFFE
Parryville	Parryville Hall		PARRYVILLE
Pemberton	Pemberton Community Centre	Club St	PEMBERTON
Perth (Forrest)	Perth Town Hall	Hay St	PERTH
Picton	Picton Primary School	Jeffery Rd	BUNBURY
Quinninup	Quinninup Primary School		QUINNINUP
Redmond	Redmond Hall		REDMOND
Rosa Brook	Rosa Brook Hall		ROSA BROOK
Rottnest (Forrest)	Rottnest Primary School		ROTTNEST ISLAND
Scotsdale	Scotsdale Hall		SCOTSDALE
Sealinks	Sealinks Pre-primary Centre	Hastie Street	BUNBURY
South Bunbury	South Bunbury Pre-primary Centre	Queen Street	BUNBURY
South Stirling	South Stirling Primary School		SOUTH STIRLING
Spencer Park	Spencer Park Primary School	Hardie Rd	ALBANY
Tingledale	Tingledale Hall		TINGLEDALE
Vasse	Vasse Primary School		VASSE
Villa Maria	Villa Maria Nursing Home	Bussell Hwy	BUSSELTON
Walpole	Walpole Primary School	Swan Street	WALPOLE
Wellstead	Wellstead Hall		WELLSTEAD
Witchcliffe	Witchcliffe Hall		WITCHCLIFFE
Withers	Withers Pre-primary Centre	Westwood St	BUNBURY
Wollaston	Bunbury Catholic College	Rodsted Street	BUNBURY
Yakamia	Yakamia Primary School	Beaufort Rd	ALBANY
Yallingup	Yallingup Hall		YALLINGUP
Yoongarillup	Yoongarillup Hall		YOONGARILUP
Yornup	Yornup Hall	South Western Hwy	YORNUP
			
			
Fremantle			
Polling Place Name	Premises	Address	Suburb
Attadale	Attadale Primary School	Wichmann Rd	ATTADALE
Atwell	Atwell Primary School	Lydon Blvd	ATWELL
Beaconsfield	Beaconsfield Primary School	Hale St	BEACONSFIELD
Bibra Lake	Bibra Lake Primary School	Annois Rd	BIBRA LAKE
Bicton	Bicton Primary School	View Tce	BICTON
Broome (Fremantle)	Broome Shire Hall	Weld St	BROOME
Carnarvon (Fremantle)	Carnarvon Senior High School	Cleaver Street	CARNARVON
Coogee Beach	Coogee Beach Community Hall	Arlington Loop	COOGEE
Coolbellup	Coolbellup Primary School	Hilory St	COOLBELLUP
Coolbellup East	North Lake Primary School	Montague Way	COOLBELLUP
East Fremantle	East Fremantle Primary School	Forrest St	FREMANTLE
Exmouth (Fremantle)	Exmouth Shire Hall	Maidestone Cres	EXMOUTH
Fremantle	Fremantle Technical College	41 South Tce	FREMANTLE
Hamilton Hill East	East Hamilton Hill Primary School	Bradbury Rd	HAMILTON HILL
Hamilton Hill North	Winterfold Primary School	Annie St	BEACONSFIELD
Hamilton Hill South	Southwell Primary School	Grandpre Cres	HAMILTON HILL
Hilton	Hilton Primary School	Rennie Cres	HILTON
Jandakot	Jandakot Primary School	Baningan Ave	SUCCESS
Kalbarri (Fremantle)	Kalbarri - Allen Community Centre	Grey Street	KALBARRI
Kardinya (Fremantle)	Kardinya Primary School	Ochiltree Way	KARDINYA
Kardinya West	North Lake Senior Campus	Winterfold Rd	KARDINYA
Lakeland	Lakeland Senior High School	South Lake Dr	SOUTH LAKE
Melville Heights	Melville Girl Guide Hall	Kitchener Rd	MELVILLE
Melville South	Melville Senior High School	Potts St	MELVILLE
Munster	South Coogee Primary School	Russell Rd	MUNSTER
Myaree	Melville Primary School	Kitchener Rd	MELVILLE
North Fremantle	North Fremantle Community Centre	2 Thompson Rd	NORTH FREMANTLE
Palmyra	Palmyra Primary School	McKimmie Rd	PALMYRA
Palmyra North	Anglican Church Hall	2 Hammad St	PALMYRA
Perth (Fremantle)	Perth Town Hall	Hay St	PERTH
Richmond	Richmond Primary School	Windsor Rd	EAST FREMANTLE
Rottnest (Fremantle)	Rottnest Primary School		ROTTNEST ISLAND
Samson	Samson Primary School	Lawrence Way	SAMSON
South Fremantle	South Terrace Primary School	Alma St	FREMANTLE
South Lake	South Lake Primary School	Mason Ct	SOUTH LAKE
Spearwood	Spearwood Primary School	Gerald St	SPEARWOOD
Spearwood South	Newton Primary School	Marvell Ave	SPEARWOOD
Spearwood West	Phoenix Primary School	Phoenix Rd	SPEARWOOD
Wattleup	Wattleup Primary School	Hitchcock Pl	WATTLEUP
White Gum Valley	White Gum Valley Primary School	Hope St	WHITE GUM VALLEY
Willagee	Willagee Primary School	Drury St	WILLAGEE
Willagee East	Carawatha Primary School	North Lake Rd	WILLAGEE
Yangebup	Yangebup Primary School	Moorhen Dr	YANGEBUP
Yangebup South	MacKillop Catholic Primary School	340 Yangebup Rd	YANGEBUP
			
			
Kalgoorlie			
Polling Place Name	Premises	Address	Suburb
Ajana	Ajana Hall	Off Ajana-Kalbarri Road	AJANA
Argyle	Argyle SMQ	Argyle Village	ARGYLE
Balgo	Balgo Catholic School	Balgo PMB 2 Via	HALLS CREEK
Barrow Island	Barrow Island Admin Building	Wapet BW I	BARROW ISLAND
Bodallin	Bodallin Primary School	Great Eastern Hwy	BODALLIN
Boulder	Boulder Town Hall	Burt Street	BOULDER
Broome (Kalgoorlie)	Broome Shire Hall	Weld St	BROOME
Broome West	Cable Beach Primary School	Lot 2439 Dakas St	BROOME
Bullfinch	Bullfinch CWA Hall	Dorothy Street	BULLFINCH
Burracoppin	Burracoppin Primary School	Station Street	BURRACOPPIN
Carnarvon (Kalgoorlie)	Carnarvon Senior High School	Cleaver Street	CARNARVON
Carnarvon East	Carnarvon East Primary School	Marmion Street	CARNARVON
Cascade	Cascade Primary School	Asha Court	CASCADE
Castletown	Castletown Primary School	Easton Rd	ESPERANCE
Condingup	Condingup Primary School	Sutcliffe Street	CONDINGUP
Cooke Point	Port Hedland Primary School	Cnr Corney & Athol Sts	PORT HEDLAND
Coolgardie	Coolgardie Recreation Centre	Sylvester Street	COOLGARDIE
Coral Bay	Coral Bay Shopping Centre	Rear Reef Cafe	CORAL BAY
Cue	Cue Court House	Austin Street	CUE
Dalyup	Dalyup Progress Assoc Hall	South Coast Hwy	DALYUP
Dampier	Dampier Primary School	Church Rd	DAMPIER
Denham	Denham Primary School (Shark Bay)	Hughes Street	DENHAM
Derby	Derby District High School	Stanley Street	DERBY
Esperance	Esperance Civic Centre	Council Place	ESPERANCE
Exmouth (Kalgoorlie)	Exmouth Shire Hall	Maidestone Cres	EXMOUTH
Fitzroy Crossing	Fitzroy Crossing District High School	Forrest Rd	FITZROY CROSSING
Gascoyne Junction	Gascoyne Junction Shire Office	Scott Street	GASCOYNE JUNCTION
Gibson	Gibson Progress Association Hall	Starr Street	GIBSON
Grass Patch	Grass Patch Primary School	Freeman Street	GRASS PATCH
Halls Creek	Halls Creek District High School	Thomas Street	HALLS CREEK
Hines Hill	Hines Hill Roadhouse	Great Eastern Hwy	HINES HILL
Horrocks	Horrocks Tennis Pavilion	Mitchell Street	HORROCKS
Jigalong	Jigalong Community School	Jigalong Community School	NEWMAN
Kalbarri (Kalgoorlie)	Kalbarri - Allen Community Centre	Grey Street	KALBARRI
Kalgoorlie	Kalgoorlie Town Hall	Hannan Street	KALGOORLIE
Kalgoorlie East	Kalgoorlie East Primary School	Mafeking Street	KALGOORLIE
Kalgoorlie Eastern Goldfields	Kalgoorlie District Education Office	Federal Road	KALGOORLIE
Kalgoorlie Halfway	Kalgoorlie John Paul College	Lionel Street	KALGOORLIE
Kalgoorlie - Hannans	Hannans Primary School	Nankiville Rd	KALGOORLIE
Kalgoorlie North	Kalgoorlie North Primary School	Campbell Street	KALGOORLIE
Kalgoorlie Regional Hospital	Kalgoorlie Regional Hospital	Piccadilly Street	KALGOORLIE
Kalgoorlie Wallace Park	Kalgoorlie Wallace Park Pre-Primary School	Bourke Street	KALGOORLIE
Kambalda	Kambalda Primary School	Larkin Street	KAMBALDA
Kambalda West	Kambalda West Primary School	Salmon Gum Rd	KAMBALDA WEST
Karratha	Karratha Senior High School	Searipple Rd	KARRATHA
Karratha West	Karratha College	Millstream Rd	KARRATHA
Kununurra	Kununurra Leisure Centre	Coolibah Dr	KUNUNURRA
Landor	Landor Race Club	Landor Rd	MEEKATHARRA
Laverton	Laverton Shire Hall	MacPherson Place	LAVERTON
Leinster	Leinster Community Hall	Link Road	LEINSTER
Leonora	Leonora Recreation Centre	Tower Street	LEONORA
Looma	Looma Community School	PMB 904 via Looma	DERBY
Marble Bar	Marble Bar Shire Hall	General St	MARBLE BAR
Marvel Loch	Marvel Loch Primary School	King Street	MARVEL LOCH
Meekatharra	Meekatharra Shire Hall	Savage Street	MEEKATHARRA
Menzies	Menzies Shire Hall	Shenton Street	MENZIES
Merredin	Merredin Court House	Mitchell St	MERREDIN
Merredin District Hospital	Merredin District Hospital	Kitchener Rd	MERREDIN
Merredin South	Merredin High School	Woolgar Ave	MERREDIN
Moorine Rock	Moorine Rock Primary School	McInnes Street	MOORINE ROCK
Mount Magnet	Mt Magnet Court House	Richardson Street	MOUNT MAGNET
Mowanjum	Mowanjum Community Building	Mowanjum Community	DERBY
Mullewa	Mullewa District High School	Jose Street	MULLEWA
Munglinup (Kalgoorlie)	Munglinup Hall	Tallarack Street	MUNGLINUP
Muntadgin	Muntadgin Primary School	Crosslands Street	MUNTADGIN
Nabawa	Nabawa (Chapman Valley) Shire Office	Chapman Valley Rd	NABAWA
Newman	Newman High school	Gregory Ave	NEWMAN
Newman North	Newman Primary School	Hilditch Ave	NEWMAN
Noonkanbah	Kulkarriya Community School (Noonkanbah)	Noonkanbah Community	FITZROY CROSSING
Norseman	Norseman Court House	Prinsep Street	NORSEMAN
Northampton	Northampton Court House	Hampton Street	NORTHAMPTON
Nullagine	Nullagine Primary School	1 Clementson St	NULLAGINE
Nulsen	Nulsen Primary School	Victoria Street	ESPERANCE
Onslow	Onslow Shire Hall	Second Ave	ONSLOW
Pannawonica	Pannawonica Primary School	Sports Way	PANNAWONICA
Paraburdoo	Paraburdoo Primary School	De Grey Rd	PARABURDOO
Perth (Kalgoorlie)	Perth Town Hall	Hay St	PERTH
Port Hedland	Port Hedland Town Hall	McGregor St	PORT HEDLAND
Roebourne	Roebourne Primary School	Cnr Scholl & Frazer Sts	ROEBOURNE
Rottnest (Kalgoorlie)	Rottnest Primary School		ROTTNEST ISLAND
Salmon Gums	Salmon Gums Primary School	Rogers Street	SALMON GUMS
Sandstone	Sandstone Shire Hall	Hack Street	SANDSTONE
Scaddan	Scaddan Primary School	Kendall Rd	SCADDAN
Southern Cross	Southern Cross Community Centre	Antares Street	SOUTHERN CROSS
South Hedland	South Hedland Primary School	Weaver Pl	SOUTH HEDLAND
South Hedland Baler	South Hedland Baler Primary School	Baler Close	SOUTH HEDLAND
Tardun	Tardun Post Office	Railway Parade	TARDUN
Telfer	Telfer Health Centre	Newcrest Mining Limited	TELFER
Tom Price	Tom Price Primary School	Wattle Street	TOM PRICE
Useless Loop	Useless Loop Primary School	Wilsons Rise	USELESS LOOP
Wangkatjungka	Wangkatjungka School (Christmas Creek)	Wangkatjungka	FITZROY CROSSING
Warmun	Warmun Community Centre	Warmun Aboriginal Community	WARMUN
Westonia	Westonia Primary School	Cnr Gold/Diorite Street	WESTONIA
Wickham	Wickham Primary School	Oleander Pl	WICKHAM
Wiluna	Wiluna Remote Community School	Wooton Street	WILUNA
Wyndham	Wyndham District High School	Coverley St	WYNDHAM
Yalgoo	Yalgoo Primary School	Henty Street	YALGOO
Yandeyarra	Yandeyarra Community Building	Yandeyarra Community	PORT HEDLAND
Yuna	Yuna Primary School		YUNA
			
			
Moore			
Polling Place Name	Premises	Address	Suburb
Beldon	Beldon Primary School	Pacific Way	BELDON
Broome (Moore)	Broome Shire Hall	Weld St	BROOME
Burns Beach	Jack Kikeros Hall	Ocean Pde	BURNS
Carnarvon (Moore)	Carnarvon Senior High School	Cleaver Street	CARNARVON
Clarkson	Clarkson Primary School	Aldersea Cir	CLARKSON
Connolly	Connolly Primary School	Fairway Cir	CONNOLLY
Craigie	Craigie Senior High School	Arawa Pl	CRAIGIE
Currambine	Currambine Primary School	Ambassador Dr	CURRAMBINE
Duncraig	Duncraig Primary School	Roche Rd	DUNCRAIG
Duncraig East (Moore)	Davallia Primary School	Juniper Way	DUNCRAIG
Duncraig North	Glengarry Primary School	Doveridge Dr	DUNCRAIG
Duncraig South	Poynter Primary School	Poynter Dr	DUNCRAIG
Edgewater	Edgewater Primary School	Treetop Ave	EDGEWATER
Exmouth (Moore)	Exmouth Shire Hall	Maidestone Cres	EXMOUTH
Heathridge	Poseidon Primary School	Poseidon Rd	HEATHRIDGE
Heathridge East	Eddystone Primary School	Littorina Ave	HEATHRIDGE
Hillarys	Lymburner Primary School	Lymburner Dr	HILLARYS
Hillarys North	Flinders Park Community Hall	Broadbeach Blvd	HILLARYS
Joondalup	Joondalup Primary School	Blue Mountain Dr	JOONDALUP
Kalbarri (Moore)	Kalbarri - Allen Community Centre	Grey Street	KALBARRI
Kallaroo	Springfield Primary School	Bridgewater Dr	KALLAROO
Kinross	Kinross Primary School	Kinross Dr	KINROSS
Merriwa	Merriwa Primary School	Baltimore Pde	MERRIWA
Mindarie	Mindarie Primary School	Rio Marina Way	MINDARIE
Mullaloo	Mullaloo Heights Primary School	Charonia Way	MULLALOO
Neerabup	Neerabup Primary School	Mist Pl	NEERABUP
Ocean Reef	Ocean Reef Senior High School	Venturi Dr	OCEAN REEF
Ocean Reef North	Beaumaris Primary School	Santiago Pkwy	OCEAN REEF
Padbury	Padbury Primary School	Macdonald Ave	PADBURY
Padbury South	Padbury Catholic Primary School	O'Leary Rd	PADBURY
Perth (Moore)	Perth Town Hall	Hay St	PERTH
Quinns Rock	Quinns Rocks Primary School	Rees Dr	QUINNS ROCKS
Rottnest (Moore)	Rottnest Primary School		ROTTNEST ISLAND
Sorrento (Moore)	Sorrento Primary School	Elfreda Ave	SORRENTO
Sorrento Beach (Moore)	Sorrento Surf Club Hall	West Coast Dr	SORRENTO
Two Rocks	Two Rocks Recreation Centre	Lisford Ave	TWO ROCKS
Wanneroo (Moore)	Wanneroo Primary School	Wanneroo Rd	WANNEROO
Wanneroo East (Moore)	Wanneroo Senior High School	Quarkum St	WANNEROO
Yanchep	Yanchep District High School	Lagoon Dr	YANCHEP
			
			
O'Connor			
Polling Place Name	Premises	Address	Suburb
Allanson	Allanson Primary School		ALLANSON
Ardath	Ardath Amenities Centre		ARDATH
Arthur River	Arthur River Hall		ARTHUR RIVER
Australind	Australind Community Hall	Paris Rd	AUSTRALIND
Australind North	Parkfield Primary School	Garfield Drive	AUSTRALIND
Badgebup	Badgebup Hall		BADGEBUP
Badgingarra	Badgingarra Community Centre		BADGINGARRA
Ballidu	Ballidu Primary School	Fairbank St	BALLIDU
Beachlands	Beachlands Primary School	Whitfield Street	BEACHLANDS
Beacon	Beacon CWA Hall		BEACON
Bencubbin	Bencubbin Shire Office	Monger Street	BENCUBBIN
Benger	Benger Community Centre		BENGER
Bindi Bindi	Bindi Bindi Primary School		BINDI BINDI
Binningup	Binningup Country Club		BINNINGUP
Bluff Point	Bluff Point Primary School	Mitchell Street	BLUFF POINT
Boddington	Boddington District High School	Bannister Rd	BODDINGTON
Bolgart	Bolgart Primary School	Smith Street	BOLGART
Borden	Borden Hall	Stone Street	BORDEN
Boscabel	Boscabel Hall		BOSCABEL
Boxwood Hill	Boxwood Hill Community Centre		BOXWOOD HILL
Bremer Bay	Bremer Bay Primary School		BREMER BAY
Brookton	Brookton District High School		BROOKTON
Broome (O'Connor)	Broome Shire Hall	Weld St	BROOME
Broomehill	Broomehill Hall		BROOMEHILL
Bruce Rock	Bruce Rock Court House	Johnson Street	BRUCE ROCK
Brunswick	Brunswick Primary School	Vincent Street	BRUNSWICK
Bullaring	Bullaring Community Centre		BULLARING
Bulyee	Bulyee Hall		BULYEE
Buntine	Buntine Primary School	Douglas Street	BUNTINE
Cadoux	Cadoux Primary School	James St	CADOUX
Calingiri	Calingiri Primary School	Cavell Street	CALINGIRI
Cape Burney	Greenough Rivermouth Caravan Park		CAPE BURNEY
Carnamah	Carnamah District High School	McPherson Street	CARNAMAH
Carnarvon (O'Connor)	Carnarvon Senior High School	Cleaver Street	CARNARVON
Cervantes	Cervantes Community Centre		CERVANTES
Clifton Park	Clifton Park Primary School	Lucy Victoria Ave	CLIFTON PARK
Collie	Miners Institute	Throssell St	COLLIE
Collie Central	Fire Station	54 Forrest St	COLLIE
Collie District Hospital	Collie Ambulance Centre	66 Steere St	COLLIE
Collie North	St Edmunds Campus	205 Princep Street	COLLIE
Coomberdale	Coomberdale Hall		COOMBERDALE
Coorow	Coorow Primary School		COOROW
Corrigin	Corrigin District High School	Hill Street	CORRIGIN
Cranbrook	Cranbrook Memorial Hall		CRANBROOK
Cuballing	Cuballing Hall		CUBALLING
Cunderdin	Cunderdin District High School	Cubbine Street	CUNDERDIN
Dalwallinu	Dalwallinu District High School	Johnson Street	DALWALLINU
Dandaragan	Dandaragan Primary School		DANDARAGAN
Darkan	Darkan Shire Hall	Burrowes St	DARKAN
Dongara	Dongara Shire Hall	Waldeck St	DONGARA
Doodlakine	Doodlakine Primary School	Spring Street	DOODLAKINE
Dowerin	Dowerin Lesser Hall		DOWERIN
Dudinin	Dudinin Agricultural Hall	Fence Rd	DUDININ
Dumbleyung	Dumbelyung District High School	Taylor Street	DUMBLEYUNG
Duranillin	Duranillin Hall		DURANILLIN
Eneabba	Eneabba Primary School		ENEABBA
Ewington	Ewington Old School Building		EWINGTON
Exmouth (O'Connor)	Exmouth Shire Hall	Maidestone Cres	EXMOUTH
Fitzgerald	Fitzgerald Hall		FITZGERALD
Forest Hill	Forest Hill Hall		FOREST HILL
Frankland	Frankland Hall		FRANKLAND
Gairdner River	Gairdner River Primary School	Gairdner South Rd	GAIRDNER RIVER
Geraldton	Geraldton Civic Centre	Cathedral Ave	GERALDTON
Geraldton Central	Geraldton Primary School	Fitzgerald Street	GERALDTON
Geraldton Regional Hospital	Geraldton Regional Hospital	Shenton Street	GERALDTON
Geraldton St John of God Hospital	St John of God Hospital	Cathedral Ave	GERALDTON
Gnowangerup	Gnowangerup Memorial Hall	Youngenup Rd	GNOWANGERUP
Goomalling	Goomalling Sports Pavilion	Quinlan & Hoddy Street	GOOMALLING
Harvey	Harvey Primary School	Gibbs Street	HARVEY
Highbury	Highbury Hall		HIGHBURY
Hopetoun	Hopetoun Hall	Veal Street	HOPETOUN
Hyden	Hyden Primary School	Naughton Street	HYDEN
Jennacubbine	Jennacubbine Hall		JENNACUBBINE
Jerdacuttup	Jerdacuttup Primary School		JERDACUTTUP
Jerramungup	Jerramungup District High School	Lancaster Rd	JERRAMUNGUP
Jingalup	Jingalup Golf Club		JINGALUP
Jurien	Jurien District High School	Hamersley St	JURIEN
Kalannie	Kalannie Primary School		KALANNIE
Kalbarri (O'Connor)	Kalbarri - Allen Community Centre	Grey Street	KALBARRI
Karlgarin	Karlgarin Primary School		KARLGARIN
Katanning	Katanning Uniting Church Hall	Taylor Street	KATANNING
Katanning District Hospital	Katanning District Hospital	Kobeelya Ave	KATANNING
Kellerberrin	Kellerberrin Memorial Hall	Massingham St	KELLERBERRIN
Kendenup	Kendenup Primary School		KENDENUP
Kojonup	Kojonup RSL Hall	Albany Hwy	KOJONUP
Kondinin	Kondinin Primary School	Graham Street	KONDININ
Koorda	Koorda Primary School	Birdwood Street	KOORDA
Kukerin	Kukerin Primary School	Bennett Street	KUKERIN
Kulin	Kulin Memorial Hall	Johnston Street	KULIN
Kununoppin	Kununoppin Primary School	Hughes Street	KUNUNOPPIN
Lake Clifton	Lake Clifton Fire Brigade Hall	Tuart Grove Ave	LAKE CLIFTON
Lake Grace	Lake Grace District High School	Absolon Street	LAKE GRACE
Lake King	Lake King Primary School	Ravensthorpe Rd	LAKE KING
Latham	Latham Primary School	Chapple Street	LATHAM
Leeman	Leeman Primary School		LEEMAN
Leschenault	Settlers' Hall	Marine Drive	AUSTRALIND
Meckering	Meckering Primary School	Knight Street	MECKERING
Miling	Miling Primary School		MILING
Mingenew	Mingenew Primary School	Victoria Street	MINGENEW
Mogumber	Mogumber Hall		MOGUMBER
Moonyoonooka	Moonyoonooka Polocross Club	Geraldton Mt Magnet Rd	MOONYOONOOKA
Moora	Moora Court House	Dandaragan Street	MOORA
Morawa	Morawa Council Chambers	Dreghorn Street	MORAWA
Mount Barker	Mount Barker Town Hall	Muir Street	MOUNT BARKER
Mount Tarcoola	Mount Tarcoola Community Hall		MOUNT TARCOOLA
Mount Walker	Mount Walker Primary School		MOUNT WALKER
Mukinbudin	Mukinbudin Shire Office	Maddock St	MUKINBUDIN
Munglinup (O'Connor)	Munglinup Hall	Tallarack Street	MUNGLINUP
Muradup	Muradup Hall		MURADUP
Narembeen	Narembeen District High School	Ada Street	NAREMBEEN
Narrikup	Narrikup Hall		NARRIKUP
Narrogin	Narrogin Railway Institute Hall	Federal St	NARROGIN
Narrogin Regional Hospital	Narrogin Regional Hospital	Williams Rd	NARROGIN
Newdegate	Newdegate Primary School		NEWDEGATE
New Norcia	Benedictine Monastery		NEW NORCIA
Nungarin	Nungarin Primary School	Danberrin Rd	NUNGARIN
Nyabing	Nyabing Town Hall	Richmond Street	NYABING
Ongerup	Ongerup Primary School		ONGERUP
Perenjori	Perenjori Primary School		PERENJORI
Perth (O'Connor)	Perth Town Hall	Hay St	PERTH
Pingaring	Pingaring CWA Hall		PINGARING
Pingelly	Pingelly Town Hall		PINGELLY
Pingrup	Pingrup Hall		PINGRUP
Pithara	Pithara Hall	Great Northern Hwy	PITHARA
Popanyinning	Popanyinning Hall		POPANYINNING
Porongurup	Porongurup Hall	Porongurup Rd	PORONGURUP
Quairading	Quairading District High School	McLennon Street	QUAIRADING
Quindanning	Quindanning Hall		QUINDANNING
Rangeway	Rangeway Primary School	Cassia Street	RANGEWAY
Ravensthorpe	Ravensthorpe District High School	Morgan St	RAVENSTHORPE
Rocky Gully	Rocky Gully Primary School	Arbour Street	ROCKY GULLY
Roelands	Roelands Primary School	Government Rd	ROELANDS
Rottnest (O'Connor)	Rottnest Primary School		ROTTNEST ISLAND
Shackleton	Shackleton CWA Rooms	Jerymn Street	SHACKLETON
Spalding	Spalding Family Centre	75 Mitchell St	SPALDING
Tambellup	Tambellup Shire Hall	Norrish Street	TAMBELLUP
Tammin	Tammin Primary School	Ridley Street	TAMMIN
Three Springs	Three Springs Primary School	Carter Street	THREE SPRINGS
Tincurrin	Tincurrin Primary School		TINCURRIN
Trayning	Don Mason Community Centre	Railway St	TRAYNING
Varley	Varley Primary School	Thomas Street	VARLEY
Waggrakine	Waggrakine Primary School	Hall Rd	WAGGRAKINE
Wagin	Wagin Court House	Tudor Street	WAGIN
Walkaway	Walkaway Primary School	Evans Street	WALKAWAY
Wandering	Wandering Primary School		WANDERING
Waroona	Waroona Senior Citizens' Centre	Millar Street	WAROONA
Watheroo	Watheroo Primary School		WATHEROO
Wickepin	Wickepin Primary School	Henry Street	WICKEPIN
Williams	Williams RSL Hall	Brooking Street	WILLIAMS
Wilson Park	Wilson Park Primary School	Porter Street	COLLIE
Wongan Hills	Wongan Hills District High School	Quinlan Street	WONGAN HILLS
Wonthella	Allendale Primary School	Wittenoom Street	WONTHELLA
Woodanilling	Woodanilling Shire Hall		WOODANILLING
Woogenellup	Woogenellup Hall		WOOGENELLUP
Wubin	Wubin Primary School		WUBIN
Wyalkatchem	Wyalkatchem District High School	Honour Ave	WYALKATCHEM
Yarloop	Yarloop Hall	Station Street	YARLOOP
Yealering	Yealering Primary School		YEALERING
Yerecoin	Yerecoin Hall		YERECOIN
Yorkrakine	Yorkrakine Hall	Tammin Wyalkatchem Rd	YORKRAKINE
			
			
Pearce			
Polling Place Name	Premises	Address	Suburb
Bakers Hill	Bakers Hill Hall	Great Eastern Hwy	BAKERS HILL
Bellevue (Pearce)	Bellevue Hall	Helen St	BELLEVUE
Beverley	Beverley Town Hall	Vincent Street	BEVERLEY
Bindoon	Bindoon Ambulance Hall	Great Northern Hwy	BINDOON
Broome (Pearce)	Broome Shire Hall	Weld St	BROOME
Bullsbrook	Bullsbrook High School	Brearley St	BULLSBROOK
Carmel	Carmel District Hall	Carmel Rd	CARMEL
Carnarvon (Pearce)	Carnarvon Senior High School	Cleaver Street	CARNARVON
Chidlow	Chidlow Primary School	Lilydale Rd	CHIDLOW
Dale	Dale River Tennis Club	Brookton Hwy	WEST DALE
Darlington	Darlington Primary School	Glen Rd	DARLINGTON
Ellenbrook	Ellenbrook Primary School	64 Fortescue Pl	ELLENBROOK
Exmouth (Pearce)	Exmouth Shire Hall	Maidestone Cres	EXMOUTH
Forrestfield	Forrestfield Primary School	Sussex Rd	FORRESTFIELD
Forrestfield North	Forrestfield High School	Berkshire Rd	FORRESTFIELD
Gidgegannup	Gidgegannup Hall	Toodyay Rd	GIDGEGANNUP
Gingin	Granville Civic Centre	Weld Street	GINGIN
Glen Forrest	Glen Forrest Hall	Marnie Rd	GLEN FORREST
Gooseberry Hill	Gooseberry Hill Community Centre	Ledger Rd	GOOSEBERRY HILL
Grass Valley	Grass Valley Hall	Wilson St	GRASS VALLEY
Greenhills	Greenhills Hall	Greenhills Rd	GREENHILLS
Greenmount	Greenmount Primary School	Innamincka Rd	GREENMOUNT
Guilderton	Guilderton Hall	Wedge Street	GUILDERTON
Helena Valley	Helena Valley Recreation Hall	Cnr Scott St & Clayton Rd	HELENA VALLEY
Henley Brook	West Swan Hall	Cnr West Swan Rd/Henley St	HENLEY BROOK
Herne Hill	Herne Hill Primary School	Argyle St	HERNE HILL
Kalamunda	Kalamunda Agricultural Hall	Canning Rd	KALAMUNDA
Kalamunda North	Kalamunda Primary School	Heath Rd	KALAMUNDA
Kalbarri (Pearce)	Kalbarri - Allen Community Centre	Grey Street	KALBARRI
Karragullen	Karragullen District Hall	Old Station St	KARRAGULLEN
Koongamia	Koongamia Hall	Banjine Rd	KOONGAMIA
Lancelin	Lancelin Primary School	Gingin Rd	LANCELIN
Ledge Point	Ledge Point Community Hall	381 Turner St	LEDGE POINT
Lesmurdie	Lesmurdie Primary School	Sanderson Rd	LESMURDIE
Lower Chittering	Lower Chittering Volunteer Fire Brigade Station	Cnr Chittering and Muchea East Rds	LOWER CHITTERING
Mahogany Creek	Mahogany Creek Hall	Cnr Jacoby St & Strettle Rd	MAHOGANY CREEK
Maida Vale	Maida Vale Primary School	Kalamunda Rd	MAIDA VALE
Midland (Pearce)	Midland Enterprise Centre	276 Great Eastern Hwy	MIDLAND
Mount Helena	Mount Helena Community Centre	Keane St East	MOUNT HELENA
Muchea	Muchea Community Hall	Archibald St	MUCHEA
Mundaring	Mundaring Town Hall	Cnr Jacoby & Nichol Sts	MUNDARING
Northam	Northam Memorial Hall	Fitzgerald St	NORTHAM
Northam East	Northam Primary School	Duke St	NORTHAM
Northam North	Avonvale Primary School	Hutt St	NORTHAM
Parkerville	Parkerville Primary School	Windoo Rd	PARKERVILLE
Perth (Pearce)	Perth Town Hall	Hay St	PERTH
Pickering Brook	Pickering Brook Primary School	Pickering Brook Rd	PICKERING BROOK
Roleystone	Roleystone Primary School	Robin Rd	ROLEYSTONE
Rottnest (Pearce)	Rottnest Primary School		ROTTNEST ISLAND
Sawyers Valley	Sawyers Valley Primary School	Barlow St	SAWYERS VALLEY
Seabird	Seabird Community Hall	Chalon Ave	SEABIRD
Stoneville	Stoneville Hall	Bentley St	STONEVILLE
Stratton	Middle Swan Primary School	Lewis Jones Cross	STRATTON
Swan View (Pearce)	Swan View High School	Weld Rd	SWAN VIEW
Toodyay	Toodyay Memorial Hall	Stirling Tce	TOODYAY
Upper Swan	Upper Swan Primary School	Great Northern Hwy	UPPER SWAN
Walliston	Walliston Primary School	Dianella Rd	WALLISTON
Wattle Grove	Wattle Grove Primary School	Welshpool Rd	WATTLE GROVE
Woodridge	Woodridge Community Centre	King Dr	WOODRIDGE
Wooroloo	Wooroloo Primary School	Wade St	WOOROLOO
Wundowie	Wundowie Primary School	Boronia Ave	WUNDOWIE
York	York Primary School	Howick St	YORK
			
			
Perth			
Polling Place Name	Premises	Address	Suburb
Alexander Park	Coolbinia Pre Primary	Holmfirth St	MENORA
Ashfield	Ashfield Primary School	Margaret St	ASHFIELD
Bassendean	Anzac Tce Primary School	Anzac Tce	BASSENDEAN
Bassendean South	Bassendean Primary School	65 West Rd	BASSENDEAN
Bayswater	Senior Citizens Centre	27 King William Street	BAYSWATER
Bedford Park	Bedford Scout Hall	Birkett Street	BEDFORD
Bedford West	St Peters Hall	93 Wood St	INGLEWOOD
Beechboro	Beechboro Primary School	King Rd	BEECHBORO
Beechboro East	East Beechboro Primary School	Brockmill Ave	BEECHBORO
Beechboro West (Perth)	John Septimus Roe Anglican Community School	Blackboy Way	BEECHBORO
Bellevue (Perth)	Bellevue Hall	Helen St	BELLEVUE
Broome (Perth)	Broome Shire Hall	Weld St	BROOME
Carnarvon (Perth)	Carnarvon Senior High School	Cleaver Street	CARNARVON
Caversham	Caversham District Hall	West Swan Rd	CAVERSHAM
Coolbinia	Coolbinia Primary School	Bradford Street	COOLBINIA
Dianella	Islamic College	Cleveland Street	DIANELLA
Dianella Central	Autumn Centre	18 Kerry Street	DIANELLA
Dianella North	West Morley Primary School	Fitzroy Street	DIANELLA
East Perth	Homeswest Building	99 Plain Street	EAST PERTH
Eden Hill	Eden Hill Primary School	Ivanhoe Street	EDEN HILL
Embleton	Embleton Primary School	Collier Rd	EMBLETON
Exmouth (Perth)	Exmouth Shire Hall	Maidestone Cres	EXMOUTH
Forrest Park	Mt Lawley TAFE College	Harold Street	MOUNT LAWLEY
Guildford (Perth)	Guildford Town Hall	James Street	GUILDFORD
Hampton	Hampton Senior High School	Morley Dve E	MORLEY
Hampton Park (Perth)	Hampton Park Primary School	Hamersley Place	MORLEY
Highgate	Highgate Primary School	Lincoln Street	HIGHGATE
Hillcrest	Hillcrest Primary School	Coode Street	BAYSWATER
Inglewood	Inglewood Masonic Hall	Carrington Street	INGLEWOOD
Inglewood Brightwater	Inglewood Brightwater	4 Walter Rd W.	INGLEWOOD
Inglewood North	Inglewood Primary School	Normanby Rd	INGLEWOOD
Kalbarri (Perth)	Kalbarri - Allen Community Centre	Grey Street	KALBARRI
Kiara	Lockridge Senior High School	Benara Rd	KIARA
Lockridge	Lockridge Primary School	Rosher Rd	LOCKRIDGE
Maylands	Maylands Primary School	Peninsula Rd	MAYLANDS
Maylands East	East Maylands Primary School	Kelvin Street	MAYLANDS
Menora	RSL Homes	51 Alexander Dve	MENORA
Mercy Hospital	Mercy Hospital	2 Ellesmere Rd	MT LAWLEY
Midland (Perth)	Midland Enterprise Centre	276 Great Eastern Hwy	MIDLAND
Midvale	Midland TAFE College	Lloyd Street	MIDDLE SWAN
Morley	Morley Primary School	Wellington Rd	MORLEY
Mount Lawley	Mt lawley Primary School	Second Ave	MOUNT LAWLEY
Mount Lawley East	Mt Lawley Pre Primary	81 Railway Pde	MOUNT LAWLEY
Mount Lawley West	Mt Lawley Masonic Hall	48 Alma Rd	MOUNT LAWLEY
Noranda West (Perth)	North Morley Primary School	Gordon Rd West	DIANELLA
Northbridge	Perth TAFE College	25 Aberdeen St	NORTHBRIDGE
North Perth	Kyilla Primary School	Selkirk Street	NORTH PERTH
North Perth Central	North Perth Primary School	Albert Street	NORTH PERTH
Perth (Perth)	Perth Town Hall	Hay St	PERTH
Rottnest (Perth)	Rottnest Primary School		ROTTNEST ISLAND
Royal Perth Hospital	Royal Perth Hospital	Victoria Square	PERTH
Swan View (Perth)	Swan View High School	Weld Rd	SWAN VIEW
West Perth (Perth)	Greek Orthodox Church	Cnr Charles & Carr Streets	WEST PERTH
			
			
Stirling			
Polling Place Name	Premises	Address	Suburb
Balcatta	Family and Children's Services Centre	344 Albert St	BALCATTA
Balcatta Central	Balcatta Senior High School	"Performing Arts Centre, Poincaire St"	BALCATTA
Balcatta North	Takari Primary School	Rickman St	BALCATTA
Balga	Primary School	Fernhurst Cres	BALGA
Balga North	North Balga Primary School	Maitland Road	BALGA
Broome (Stirling)	Broome Shire Hall	Weld St	BROOME
Carine	Carine Senior High School	Everingham St	CARINE
Carnarvon (Stirling)	Carnarvon Senior High School	Cleaver Street	CARNARVON
Deanmore	Deanmore Primary School	Deanmore Rd	KARRINYUP
Dianella Heights	Dianella Heights Primary School	Beaman St	DIANELLA
Dianella West	Sutherland Primary School	Sutherland St	DIANELLA
Doubleview (Stirling)	Doubleview Primary School	St Brigid's Tce	DOUBLEVIEW
Doubleview Central	Guides (WA) Hall	Hancock Street	DOUBLEVIEW
Doubleview North	Newborough Primary School	Newborough St	DOUBLEVIEW
Duncraig East (Stirling)	Davallia Primary School	Juniper Way	DUNCRAIG
Exmouth (Stirling)	Exmouth Shire Hall	Maidestone Cres	EXMOUTH
Hamersley	Glendale Primary School	Glendale Ave	HAMERSLEY
Hamersley East	East Hamersley Primary School	Doon Way	HAMERSLEY
Innaloo North	Yuluma Primary School	Ambrose St	INNALOO
Kalbarri (Stirling)	Kalbarri - Allen Community Centre	Grey Street	KALBARRI
Karrinyup	Karrinyup Primary School	Hampton St	KARRINYUP
Lake Gwelup	Lake Gwelup Primary School	Porter St	GWELUP
Marmion	Marmion Primary School	Cliverton Ct	MARMION
Mirrabooka	Mirrabooka Senior High School	Nollamara Ave	NOLLAMARA
Mirrabooka Central	Dryandra Primary School	449 Dryandra Dr	MIRRABOOKA
Mirrabooka East	Boyare Primary School	Threadleaf Way	MIRRABOOKA
Nollamara	Nollamara Primary School	Harrison St	NOLLAMARA
Nollamara North	St Gerard's Primary School	Majella Rd	WESTMINSTER
Noranda West (Stirling)	North Morley Primary School	Gordon Rd West	DIANELLA
North Beach	North Beach Primary School	North Beach Rd	NORTH BEACH
North Beach Central	North Beach Autumn Centre	Castle St	NORTH BEACH
Osborne	Osborne Primary School	Albert St	OSBORNE PARK
Osborne East	St John's Ambulance Hall	197 Main St	OSBORNE PARK
Osborne Park	Osborne Park Hospital	Osborne Pl	STIRLING
Perth (Stirling)	Perth Town Hall	Hay St	PERTH
Rottnest (Stirling)	Rottnest Primary School		ROTTNEST ISLAND
Scarborough	Scarborough Uniting Church	Cnr Northstead & Moorland Sts	SCARBOROUGH
Scarborough Central (Stirling)	Scarborough Pre-Primary School	Bazaar Tce	SCARBOROUGH
Sorrento (Stirling)	Sorrento Primary School	Elfreda Ave	SORRENTO
Sorrento Beach (Stirling)	Sorrento Surf Club Hall	West Coast Dr	SORRENTO
Trigg	Trigg Surf Life Saving Club	West Coast Dr	TRIGG
Tuart Hill	Tuart Hill Primary School	Banksia St	TUART HILL
Westminster	Westminster Primary School	Marloo Rd	WESTMINSTER
Yokine	Yokine Primary School	Woodrow Ave	YOKINE
Yokine North	Yokine Shopping Centre	Corner Micheal St and Knight Ave	YOKINE
Yokine West	Yokine Pre-School Centre	Ranger Rd	YOKINE
			
			
Swan			
Polling Place Name	Premises	Address	Suburb
Beckenham	Beckenham Primary School	386 Railway Parade	BECKENHAM
Belmont	Belmont Primary School	213 Great Eastern Highway	BELMONT
Bentley	Bentley Pre School Centre	6 John Street	BENTLEY
Bentley South	Bentley Primary School	Hedley Street	BENTLEY
Bentley West	South Bentley Community Care Centre	Hillview Place	BENTLEY
Broome (Swan)	Broome Shire Hall	Weld St	BROOME
Cannington	Cannington Senior High School	Cecil Avenue	CANNINGTON
Cannington East	Gibbs Street Primary School	Gibbs Street	EAST CANNINGTON
Carlisle	Harold Hawthorne Centre	2 Memorial Avenue	CARLISLE
Carnarvon (Swan)	Carnarvon Senior High School	Cleaver Street	CARNARVON
Cloverdale	Old Video Shop	Cnr Gabriel & Belgravia Streets	CLOVERDALE
Cloverdale North	Belmay Primary School	410 Sydenham Street	CLOVERDALE
Cloverdale West	Belmont Senior High School	Fisher Street	CLOVERDALE
Como	Como P & C Hall	Coode Street	COMO
Como North	Collier Primary School	Hobbs Avenue	COMO
Como South	St Augustines Church Hall	Cale Street	COMO
Exmouth (Swan)	Exmouth Shire Hall	Maidestone Cres	EXMOUTH
Guildford (Swan)	Guildford Town Hall	James Street	GUILDFORD
Hazelmere	Hazelmere Community Hall	Bushmead Road	HAZELMERE
High Wycombe	High Wycombe Primary School	Newburn Road	HIGH WYCOMBE
High Wycombe South	Edney Primary School	Cnr Edney & Newburn Roads	HIGH WYCOMBE
Kalbarri (Swan)	Kalbarri - Allen Community Centre	Grey Street	KALBARRI
Kensington	Kensington Primary School	71 Banksia Terrace	KENSINGTON
Kewdale	Kewdale Senior High School	President Street	KEWDALE
Kewdale West	Carlisle Primary School	Cnr Wright & Orrong Roads	KEWDALE
Lathlain	Lathlain Primary School	120 Howick Street	LATHLAIN
Manning	St Pius X Parish Hall	23 Paterson Street	MANNING
Manning North	Koonawara Primary School	Goss Avenue	MANNING
Millen	Millen Primary School	Playfield Street	EAST VICTORIA PARK
Perth (Swan)	Perth Town Hall	Hay St	PERTH
Perth Domestic Airport	Ansett Domestic Terminal	Brearley Avenue	PERTH AIRPORT
Perth International Airport	International Terminal	Horrie Miller Drive	PERTH AIRPORT
Queens Park	Queens Park Primary School	202 Treasure Road	QUEENS PARK
Redcliffe	Redcliffe Primary School	Kanowna Avenue East	REDCLIFFE
Rivervale	Divine Mercy College	20 Surrey Road	RIVERVALE
Rivervale North	Tranby Primary School	99 Acton Avenue	RIVERVALE
Rottnest (Swan)	Rottnest Primary School		ROTTNEST ISLAND
Rowethorpe	Rowethorpe Retirement Village	Jacaranda Avenue	BENTLEY
South Perth	South Perth Primary School	51 Forrest Street	SOUTH PERTH
South Perth Central	City of South Perth Civic Centre	South Terrace	SOUTH PERTH
South Perth North	Legacy House	64 Mill Point Road	SOUTH PERTH
Swan Cottage Homes	Swan Cottage Homes	26 Plantation Drive	BENTLEY
Victoria Park	Victoria Park Primary School	1 Cargill Street	VICTORIA PARK
Victoria Park Central	The Park Recreation Centre	Cnr Kent & Gloucester Streets	EAST VICTORIA PARK
Victoria Park East	East Victoria Park Primary School	Beatty Avenue	EAST VICTORIA PARK
Wilson	Wilson Primary School	Armstrong Road	WILSON
			
			
Tangney			
Polling Place Name	Premises	Address	Suburb
Applecross	Applecross Primary School	Kintail Rd	APPLECROSS
Ardross	St Benedict's Primary School	Alness St	ARDROSS
Ardross West	Applecross Senior High School	Links Rd	ARDROSS
Bateman	Bateman Primary School	20 Bartling Cres	BATEMAN
Booragoon	Booragoon Primary School	Clements Rd	BOORAGOON
Brentwood	Brentwood Primary School	Moolyeen Rd	BRENTWOOD
Broome (Tangney)	Broome Shire Hall	Weld St	BROOME
Bull Creek	Bull Creek Primary School	Hardy St	BULL CREEK
Bull Creek East	Oberthur Primary School	Nicholls Cres	BULL CREEK
Bull Creek North	"Admin Bldg, Air Force Estate"	Bull Creek Dr	BULL CREEK
Canning Vale	Canning Vale Primary School	The Ramble	CANNING VALE
Carnarvon (Tangney)	Carnarvon Senior High School	Cleaver Street	CARNARVON
Exmouth (Tangney)	Exmouth Shire Hall	Maidestone Cres	EXMOUTH
Ferndale	Ferndale Primary School	Karri Way	FERNDALE
Ferndale East	Kinlock Primary School	Latham Rd	FERNDALE
Kalbarri (Tangney)	Kalbarri - Allen Community Centre	Grey Street	KALBARRI
Kardinya (Tangney)	Kardinya Primary School	Ochiltree Way	KARDINYA
Langford	Langford Primary School	Southgate Rd	LANGFORD
Leeming	Leeming Primary School	Meharry Rd	LEEMING
Leeming East	Banksia Park Primary School	Hicks St	LEEMING
Leeming West	West Leeming Primary School	Westall Tce	LEEMING
Lynwood	Lynwood Primary School	Purley Cres	LYNWOOD
Mount Pleasant	Mount Pleasant Primary School	Queens Rd	MOUNT PLEASANT
Parkwood	Lynwood Senior High School	Metcalfe Rd	PARKWOOD
Perth (Tangney)	Perth Town Hall	Hay St	PERTH
Riverton	Riverton Primary School	Corinthian Rd East	RIVERTON
Rossmoyne	Rossmoyne Primary School	Second Ave	ROSSMOYNE
Rottnest (Tangney)	Rottnest Primary School		ROTTNEST ISLAND
Shelley	Shelley Primary School	Monota Ave	SHELLEY
Thornlie (Tangney)	Thornlie Senior High School	Ovens Road	THORNLIE
Thornlie South (Tangney)	Forest Crescent Primary School	Forest Cres	THORNLIE
Thornlie West (Tangney)	Yale Primary School	Cnr Yale & Sage Rds	THORNLIE
Willetton	Willetton Primary School	Apsley Rd	WILLETTON
Willetton East	Rostrata Primary School	Rostrata Ave	WILLETTON
Willetton North	Senior Citizens Centre	Cnr Herald Ave & High Rd	WILLETTON
Willetton South	Willetton Senior High School	Pinetree Gully Rd	WILLETTON
Winthrop	Winthrop Primary School	Jackson Ave	WINTHROP
			
			
			
			
				
				
				
				
				
				
				
				
				
				
				
				
				
				
				
				
				
				
				
				
				
				
				
				
				
				
				
				
				
				
				
				
				
				
				
				
				
				
				
				
				
				
				
				
