Senate - 1993 Election		
National List of Candidates		


Candidate	Party/Group Name	State

"ABETZ, Eric"	Liberal	TAS
"ALFORD, Ronald James"		QLD
"ANDERSON, Michael J"	Independent	NSW
"ARCHER, Brian"	Liberal	TAS
"ARCHER, Peter B"		NSW
"ARMSTRONG, Mary-Anne"	Australian Labor Party	NSW
"ASCHER, Michael"	Australian Shooters Party	NSW
"ASQUINI, Loretta"	The Victorian Greens	VIC
"AULICH, Terry"	Australian Labor Party	TAS

"BANJANIN, Toma"		VIC
"BASS, Walter"		NSW
"BAUME, Michael"	Liberal	NSW
"BECKMANN, Jane"	Green Alliance	NSW
"BEILBY, Christopher Hart"		QLD
"BELETICH, Argy"	Independent	NSW
"BELL, Laurie"	Independent	VIC
"BIRD, Henry Walter"	Liberal	QLD
"BIRD, John"	Australian Labor Party (ALP)	QLD
"BISHOP, Mark"	Australian Labor Party	WA
"BOLKUS, Nick"	Australian Labor Party	SA
"BOTTAM, Glen"	Grey Power	SA
"BOURKE, Robyn Lee"	Australian Shooters Party	NSW
"BRADSHAW, Michael"	National Party	SA
"BRANFIELD, Una"	A.I.P.P.	QLD
"BRIAN, Bernie"	Green Alliance	NSW
"BRIGHAM, Steve"	The Greens	NSW
"BROCKWELL, Maurice"	Liberal	WA
"BROOM, Bernard William"	Independent	SA
"BROSZCZYK, Greg"	Natural Law Party	TAS
"BUCHANAN, Ann"	Liberal	QLD
"BUCKLEY, Brian"	Republican Party of Australia	VIC
"BURNS, Arthur"	Australians Against Further Immigration	ACT
"BUTLER, Robert"	Citizens Electoral Councils of Australia Group	NSW

"CAMPBELL, Ian"	Liberal	WA
"CARR, Kim"	Australian Labor Party (ALP)	VIC
"CASBOLT, Diane"	Australian Democrats	VIC
"CHESTERFIELD-EVANS, Arthur"	Australian Democrats	NSW
"CLUNE, Paul"	National Party	WA
"COATES, John"	Australian Labor Party	TAS
"COBB, Teresa M."	National Party	QLD
"CODY, Matthew"	D.L.P. - Democratic Labor Party	VIC
"COHEN, Ian"	The Greens	NSW
"COLEMAN, Bruce"	Call to Australia (Fred Nile) Group	NSW
"COLLAERY, Bernard"	Independent	ACT
"COLLINS, Bob"	Australian Labor Party (ALP)	NT
"COLSTON, Malcolm"	Australian Labor Party (ALP)	QLD
"CONSANDINE, Peter"	Republican Party of Australia	NSW
"COOK, Ken"	Call to Australia (Fred Nile) Group	VIC
"COOK, Peter"	Australian Labor Party	WA
"COPPIN, Peter"	Natural Law Party	WA
"CORNISH, Jonathan"	Australian Democrats	QLD
"CREA, Pat"	D.L.P. - Democratic Labor Party	VIC
"CROMPTON, Margaret"		QLD
"CUNNINGHAM, Ross Alan"	Liberal	QLD
"CURTIS, Ian Ronald"	Liberal	VIC

"DAVIDSON, Francesca"	The Victorian Greens	VIC
"DAVIES, Caroline"	Natural Law Party	TAS
"DAVIES, Owen"	Liberal	QLD
"DE BRY, Katherine V"	Independent	NSW
"DECKER, Dianne"	Independent	NSW
"DIMITRIOU, Steve"	Independent	QLD
"DODD, Christine"	D.L.P. - Democratic Labor Party	VIC
"DWYER, David"	Independent EFF	SA

"ELLIS, Bryan T"	Independent	NSW
"ELLISON, Chris"	Liberal	WA
"ERNST, Ute"	Abolish Self Government Coalition	ACT
"EVANS, Christopher"	Australian Labor Party	WA
"EVANS, Gareth"	Australian Labor Party (ALP)	VIC

"FAULKNER, John"	Australian Labor Party	NSW
"FAZAL, Abdul Khaliq"	Independent	VIC
"FERGUSON, Alan"	Liberal	SA
"FINNEY, Rick"	Independent	WA
"FITZHARDINGE, Jody"	Natural Law Party	WA
"FLORIN, Steve"	Independent	VIC
"FOREMAN, Dominic"	Australian Labor Party	SA
"FRICKER, Ally"	The Green Party South Australia	SA
"FRY, Marion"	Tasmanian Greens	TAS

"GAJIN, Milorad"	Independent	NSW
"GARVEY, Barry"	Independent	QLD
"GEISSMANN, Mark S."	The Confederate Action Party of Australia	QLD
"GIBSON, Brian"	Liberal	TAS
"GIDDINGS, Douglas"	Independent EFF	SA
"GIDDINGS, Vanessa"	Independent EFF	SA
"GIDLEY, Brendan Frederick"	Republican Party of Australia	VIC
"GILL, Ryland E."	The Confederate Action Party of Australia	QLD
"GOOD, Michael"	Independent	VIC
"GRAHAM, Murray"	Call to Australia (Fred Nile) Group	VIC
"GRIFFITH, Steve"	Natural Law Party	VIC
"GRIFFITHS, Ray Ian"	Australian Democrats	NSW
"GRIGG, Shirley J"	Call to Australia (Fred Nile) Group	NSW
"GROUNDS, Gay"	Grey Power	NSW
"GUPTA, Satish"	Liberal	SA

"HALES, Paul"		NSW
"HAMEL-GREEN, Michael"	Independents' Network	VIC
"HARDY, Frank"	Independent	VIC
"HARMSEN, Patsy"	Australian Democrats	TAS
"HARRADINE, Brian"	Tasmanian Independent Senator Brian Harradine	TAS
"HARRISON, Yvonne"		NSW
"HAWKINS, Doug"	The Confederate Action Party of Australia	NSW
"HAY, Leone"	Citizens Electoral Councils of Australia Group	NSW
"HENDERSON, Judy"	Tasmanian Greens	TAS
"HILL, Peter"	Republican Party of Australia	SA
"HILL, Sandra"	The Confederate Action Party of Australia	QLD
"HODGSON, Helen"	Australian Democrats	WA
"HOLDER, Jack"	Grey Power	SA
"HOLLEY, John"		NSW
"HOPSON, Janelle"	Call to Australia (Fred Nile) Group	TAS
"HOPSON, Philip"	Call to Australia (Fred Nile) Group	TAS
"HUNT, Colin"	Queensland Greens	QLD
"HUTTON, Drew"	Queensland Greens	QLD

"ISHERWOOD, Noelene"	Citizens Electoral Councils of Australia Group	VIC

"JACKSON, Peter"	Natural Law Party	QLD
"JACKSON, Phillip"	Natural Law Party	WA
"JAMIESON, Ian"	Independent	TAS
"JARDINE, Michael"	National Party	WA
"JENKINS, Jean"	Australian Democrats	WA
"JEWELL, Perry J.B."	The Confederate Action Party of Australia	QLD
"JOHN, Robert"		NSW
"JONES, Peter"	Tasmanian Greens	TAS
"JOYNER, Rona"	Call to Australia (Fred Nile) Group	QLD
"JUDD, Ines"	Natural Law Party	NSW

"KAYAK, Maria"	Australian Democrats	VIC
"KELLY, De-Anne"	National Party	QLD
"KERR, Doreen"	Natural Law Party	NSW
"KERRISON, Nanette"	Natural Law Party	ACT
"KING, Michael"	Natural Law Party	WA
"KITSON, David A L"	Australians Against Further Immigration	NSW
"KLEIN, Gennie"	Republican Party of Australia	NSW
"KNOWLES, Sue"	Liberal	WA
"KOEHLER, John"	Citizens Electoral Councils of Australia Group	QLD

"LANGLEY, David"	Republican Party of Australia	WA
"LAVERY, Priscilla"		NSW
"LAVERY, Rosemarie"		NSW
"LEE, David"	National Party	WA
"LEES, Meg"	Australian Democrats	SA
"LEVY, Laurie"	Independents' Network	VIC
"LIEW, Dr Alex"		SA

"MACDONALD, Sandy"	National Party	NSW
"MACGIBBON, David"	Liberal	QLD
"MAGUIRE, Graham"	Australian Labor Party	SA
"MAIN, Peter"	Australian Democrats	ACT
"MARGETTS, Dee"	The Greens (WA)	WA
"MARTIN, Anne"	Natural Law Party	SA
"MASON, Ngaire"	Natural Law Party	VIC
"MCCALLUM, Nola"	National Party	SA
"MCCARTHY, Darby"	A.I.P.P.	QLD
"MCCAUSLAND, John Allan"	Liberal	WA
"MCCORMACK, Denis"	Australians Against Further Immigration	VIC
"MCDONALD, Rosalie Ann"	Australian Labor Party	SA
"MCGAURAN, Julian John"	National Party	VIC
"MCKAY, Alistair"	Pensioner and Citizen Initiated Referendum Alliance	VIC
"MCKAY, Neil"	Pensioner and Citizen Initiated Referendum Alliance	VIC
"MCKENZIE, David"	Australian Labor Party (ALP)	VIC
"MCLEAN, Ian"	Australian Labor Party (ALP)	QLD
"MCLENNAN, Graham Clarke"	Call to Australia (Fred Nile) Group	NSW
"MCMULLAN, Bob"	Australian Labor Party	ACT
"MCSHANE, Frances"	Tasmania Senate Team	TAS
"MICO, Domenic"	Australian Democrats	ACT
"MILLER, Helen"	Abolish Self Government Coalition	ACT
"MILTON, Malcolm Joshua"	Independent	NSW
"MINCHIN, Nick"	Liberal	SA
"MOFFATT, Gordon"	Independent	VIC
"MOLLOY, Laurence John"	Citizens Electoral Councils of Australia Group	WA
"MOORE, Evonne"	Australians Against Further Immigration	SA
"MORRIS, Dulcie"	Natural Law Party	SA
"MULHOLLAND, John"	D.L.P. - Democratic Labor Party	VIC
"MURPHY, Shayne"	Australian Labor Party	TAS

"NASRULLAH, Bilal"	Republican Party of Australia	SA
"NESCI, Frank"		WA
"NESCI, Paul John"		WA

"O'CHEE, Bill"	National Party	QLD
"O'CONNELL, Suzanne"	Australian Shooters Party	NSW
"O'ROURKE, Anne"	Independents' Network	VIC
"ORR, Ted"	Australian Shooters Party	NSW

"PARER, Warwick"	Liberal	QLD
"PAVLEKOVICH-SMITH, Ivan"	Independent	VIC
"PAYNE, Marise Ann"	Liberal	NSW
"PETHERBRIDGE, Tim"	Independent	VIC
"PINNIGER, John"	Australian Democrats	VIC
"PITT, A. R."	The Confederate Action Party of Australia	QLD
"POULOS, Patricia"		NSW
"POULSEN, Ron"		NSW
"POWELL, Janet"	Independents' Network	VIC
"PRESTON, Betty"	Grey Power	SA

"REID, Margaret"	Liberal	ACT
"REYNOLDS, Margaret"	Australian Labor Party (ALP)	QLD
"RICE, Mark"	Independent	SA
"RICHARDSON, Graham Frederick"	Australian Labor Party	NSW
"RICHARDSON, Roland"	The Confederate Action Party of Australia	WA
"RING, Patty"	Australian Labor Party (ALP)	NT
"ROBERTS, Neil"	Australian Labor Party	WA
"RODWAY, David"	Call to Australia (Fred Nile) Group	SA
"ROGERS, Beryl"	Call to Australia (Fred Nile) Group	WA
"ROGERS, Don"	Call to Australia (Fred Nile) Group	WA
"ROLO, Lord"		NSW
"ROPER, Stephen"		VIC
"ROTARU, Alex"	Citizens Electoral Councils of Australia Group	VIC
"ROWE, Michael"	D.L.P. - Democratic Labor Party	VIC
"ROYLANCE, Frances"	Grey Power	NSW
"RYAN, Glen"	Call to Australia (Fred Nile) Group	NSW

"SANTA CLAUS, O"		NSW
"SCHIRRIPA, Douglas"		SA
"SCHOLLBACH, Robert"		NSW
"SCURFIELD, Lorna"	Natural Law Party	VIC
"SEALE, John Digby"	Citizens Electoral Councils of Australia Group	WA
"SEATON, David"	Natural Law Party	ACT
"SHEEHAN, Maureen"	Australian Labor Party	ACT
"SHERLOCK, Joe"	Independent	QLD
"SHORT, Jim"	Liberal	VIC
"SIBRAA, Kerry"	Australian Labor Party	NSW
"SIMS, Alan"	Call to Australia (Fred Nile) Group	QLD
"SIRNA, Enzo"	Liberal	WA
"SMITH, E.C. (Ean)"	Independent	SA
"SMITH, Joe"	Australians Against Further Immigration	SA
"SMITH, Mike"	Natural Law Party	NSW
"SMITH, Sylvia Dianne"		QLD
"SOWADA, Karin"	Australian Democrats	NSW
"SPENCER, Naomi"	Queensland Greens	QLD
"SPENCER, Robyn Marion"	Australians Against Further Immigration	VIC
"SPIER, Lucinda"	Liberal	ACT
"SPROULE, Alan"	Tasmania Senate Team	TAS
"SQUIRRELL, David"	Call to Australia (Fred Nile) Group	SA
"STEAD, Cecily"	The Greens	NSW
"STEAR, Kathryn"	Australian Democrats	VIC
"STEPHEN, David"	Australian Democrats	TAS
"STEVENS, David Richard"		NSW
"STIRLING, Karen"		NSW
"STOTT DESPOJA, Natasha"	Australian Democrats	SA
"STRATTON, Rodney"	Republican Party of Australia	WA
"SWIFT, Stephen"	Australian Democrats	SA

"TAMBLING, Grant"	Country Liberal	NT
"TATE, Michael"	Australian Labor Party	TAS
"TCHEN, Tsebin"	Liberal	VIC
"TEAGUE, Richard C."	The Confederate Action Party of Australia	QLD
"TEALE, Leonard"		NSW
"TICKLE, Patricia"	Australian Democrats	SA
"TIERNEY, John"	Liberal	NSW
"TOSCANO, Joe"		VIC
"TROETH, Judith"	Liberal	VIC
"TRUMAN, Bob"	Country Liberal	NT
"TUCAK, John Damian"	Independent	WA
"TUCKER, Kerrie"	The Greens	ACT
"TURBAYNE, David"	The Greens	ACT

"UEBERGANG, K John"	The Confederate Action Party of Australia	NSW

"VANSTONE, Amanda"	Liberal	SA
"VAUGHAN, Salli"	Grey Power	WA
"VESCIO, Michael"		NSW

"WALL, Bill"	Liberal	VIC
"WALLACE, Joy"	The Greens	NSW
"WALTERS, Tony"	Australian Democrats	QLD
"WARD, Colin"		NSW
"WARNER, Julie"	Citizens Electoral Councils of Australia Group	QLD
"WEATHERLAKE, Ian A"	Australians Against Further Immigration	NSW
"WEEDON, Barry"		QLD
"WEISSMANN, Gerhard"	The Green Party South Australia	SA
"WELLS, Dr Geoff"	Natural Law Party	SA
"WHEATLEY, Pamela Eileen"		NSW
"WHITE, Marj"	Australian Democrats	VIC
"WILKIE, Jeff"	Australian Shooters Party	NSW
"WILLIAMS, Chris"	The Greens (WA)	WA
"WILSON, Geoff"	Natural Law Party	QLD
"WOOD, Gloria"	Citizens Electoral Councils of Australia Group	NSW
"WOOD, Robert"	Australian Democrats	VIC
"WOODLEY, John"	Australian Democrats	QLD
"WOODROW, Gayle"	Australian Democrats	QLD

"ZAKHAROV, Olive"	Australian Labor Party (ALP)	VIC
