General Information: Election 2001 - National					
Codes for Political Parties					
Below is the list of AEC codes used in the results section of this report to identify registered 					
political parties. IND and OTH are used throughout these statistics to identify Independent candidate.					
					
AEC Code	Party name				
AAP	Advance Australia Party				
ACL	Australian Labor Party/Country Labor Party**				
AFI	Australians Against Further Immigration				
ALP	Australian Labor Party (ACT Branch)				
ALP	Australian Labor Party (N.S.W. Branch)				
ALP	Australian Labor Party (Northern Territory Branch)				
ALP	Australian Labor Party (South Australia Branch)				
ALP	Australian Labor Party (State of Queensland)				
ALP	Australian Labor Party (Tasmanian Branch)				
ALP	Australian Labor Party (Victorian Branch)				
ALP	Australian Labor Party (Western Australian Branch)				
CLR	Country Labor Party				
ASP	Australian Shooters Party				
AWP	Australian Women's Party				
CEC	Citizens Electoral Council of Australia				
CLA	Curtin Labor Alliance				
CLP	Northern Territory Country Liberal Party				
CTA	Christian Democratic Party (Fred Nile Group)				
DEM	Australian Democrats				
DLP	Democratic Labor Party (DLP) of Australia				
FPY	The Fishing Party				
FST	Australia First Party				
GRN	Australian Greens				
GWA	The Greens (WA) Inc				
HAN	Pauline Hanson's One Nation				
HMP	Help End Marijuana Prohibition				
HPA	Hope Party Australia				
LEF	Lower Excise Fuel and Beer Party				
LFF	liberals for forests				
LNP	Liberal/National Party*				
LP	Liberal Party (W.A. Division) Inc.				
LP	Liberal Party of Australia (S.A. Division)				
LP	Liberal Party of Australia (Victorian Division)				
LP	Liberal Party of Australia (ACT Division)				
LP	Liberal Party of Australia (Queensland Division)				
LP	Liberal Party of Australia (Tasmanian Division)				
LP	Liberal Party of Australia (NSW Division)				
NCP	Non-Custodial Parents Party				
NDP	Nuclear Disarmament Party of Australia				
NGST	No Goods and Services Tax Party				
NP	National Party of Australia (Queensland)				
NP	National Party of Australia (WA) Inc.				
NP	National Party of Australia (N.S.W.)				
NP	National Party of Australia (Victoria)				
OCF	Helen Caldicott's - Our Common Future Party				
ORP	Outdoor Recreation Party				
PCA	Phil Cleary - Indpendent Australia				
PLP	Progressive Labour Party				
RLS	Peter Breen - Reform The Legal System				
RPA	Republican Party of Australia				
SAS	Save ADI Site Party				
TFP	Tasmania First Party				
TSP	Taxi Operators Political Service (Oceania)				
UNI	Unity - Say No To Hanson				
					
					
*	These parties stood as joint Senate groups in some States.				
**	These parties stood as a joint Senate group in New South Wales only.				
					
					
					
					
					
					
					
					
					
					
					
					
					
					
					
					
					
					
					
					
					
					
					
					
					
					
					
					
					
					
					
					
					
					
					
					
					
					
					
					
					
					
					
					
					
					
					
					
					
					
					
					
					
					
					
					
					
					
					
					
					
					
					
					
					
					
					
					
					
					
					
					
					
					
					
					
					
					
					
					
					
					
					
					
					
					
					
					
					
