House of Representatives: Election 2001 - National				
Seats Decided on Preferences				
				
New South Wales (21)				
Banks (ALP)	Farrer (LP)	New England (IND)		
Barton (ALP)	Grayndler (ALP)	Page (NP)		
Charlton (ALP)	Greenway (ALP)	Parramatta (LP)		
Cowper (NP)	Kingsford Smith (ALP)	Paterson (LP)		
Cunningham (ALP)	Lindsay (LP)	Richmond (NP)		
Dobell (LP)	Lowe (ALP)	Shortland (ALP)		
Eden-Monaro (LP)	Newcastle (ALP)	Sydney (ALP)		
				
Victoria (18)				
Ballarat (ALP)	Corio (ALP)	Jagajaga (ALP)		
Bendigo (ALP)	Deakin (LP)	La Trobe (LP)		
Bruce (ALP)	Dunkley (LP)	McEwen (LP)		
Burke (ALP)	Gippsland (NP)	McMillan (ALP)		
Chisholm (ALP)	Indi (LP)	Melbourne (ALP)		
Corangamite (LP)	Isaacs (ALP)	Melbourne Ports (ALP)		
				
Queensland (21)				
Blair (LP)	Griffith (ALP)	Longman (LP)		
Bowman (ALP)	Groom (LP)	Moreton (LP)		
Brisbane (ALP)	Herbert (LP)	Oxley (ALP)		
Capricornia (ALP)	Hinkler (NP)	Petrie (LP)		
Dickson (LP)	Kennedy (IND)	Rankin (ALP)		
Fairfax (LP)	Leichhardt (LP) 	Ryan (LP)		
Forde (LP)	Lilley (ALP)	Wide Bay (NP)		
				
Western Australia (13)				
Canning (LP)	Kalgoorlie (LP)	Perth (ALP)		
Cowan (ALP)	Moore (LP)	Stirling (ALP)		
Forrest (LP)	O'Connor (LP)	Swan (ALP)		
Fremantle (ALP)	Pearce (LP)	Tangney (LP)		
Hasluck (ALP)				
				
South Australia (6)				
Adelaide (LP)	Boothby (LP)	Kingston (ALP)		
Bonython (ALP)	Hindmarsh (LP)	Makin (LP)		
				
Tasmania (4)				
Bass (ALP)	Franklin (ALP)			
Braddon (ALP)	Lyons (ALP)			
				
Australian Capital Territory (2)				
Canberra (ALP)	Fraser (ALP)			
				
Northern Territory (2)				
Lingiari (ALP)	Solomon (CLP)			
				
Total: 87 seats decided on preferences				
				
				
				
				
				
				
				
				
				
				
				
				
				
				
				
				
